
111111111111111111111
10C0P00CCCC000000CCC1
1CC00CCC00CCC00CCC001
1CC00CCC00CCC00CCC001
1CC0000CCCC000000CCC1
1CC00CCC00CCC00CCC001
1CC00CCC00CCC00CCC001
1CC0000CCCC000000CCC1
1CC00CCC00CCC00CCC001
1CC00CCC00CCC00CCC001
10C0000CCCC000000CCE1
111111111111111111111
111111111111111111111
111111111111111111111
