
1111111111111111111111111
10C0P00CCCC000000CCCC0001
1CC00CCC00CCC00CCC00CCC01
1CC00CCC00CCC00CCC00CCC01
1CC0000CCCC000000CCCC0C01
1CC00CCC00CCC00CCC00CCC01
1CC00CCC00CCC00CCC00CCC01
1CC0000CCCC000000CCCC00C1
1CC00CCC00CCC00CCC00CCC01
1CC00CCC00CCC00CCC00CCC01
10C0000CCCC000000CCCC00E1
1111111111111111111111111
1111111111111111111111111
1111111111111111111111111
