11111111111111111111
1C0CCCCCCCCC11CCCCE1
1C1111C1111C11C11111
1C1111C1111C11C11111
1C1111C1111C11C11111
1CCCCCCCCCCCCCCCCCC1
1C1111C1C11111111C11
1CCCCCC1CCCC11CCCP11
11111111111111111111
